4 0 0 0 0 0 0 0 0 0 0 0 0 0 0 0 0 0 0 0 0 0 0 0 0 0 0 0 0 0 0 0 0 0 0 0 0 0 0 0 0 0 0 0 0 0 0 0 0 0 3 1 0 0 0 0 0 0 0 0
4 0 0 0 0 0 0 0 0 0 0 0 0 0 0 0 0 0 0 0 0 0 0 0 0 0 0 0 0 0 0 0 0 0 0 0 0 0 0 0 0 0 0 0 0 0 0 0 0 0 3 1 0 0 0 0 0 0 0 0
4 0 0 0 0 0 0 T 0 0 0 H 0 0 0 2 0 0 0 0 0 0 0 D 0 2 2 0 0 0 0 0 S 0 0 0 0 0 0 0 0 0 0 0 2 2 2 0 0 0 3 1 0 0 0 0 0 0 0 0
4 0 0 0 2 2 2 2 2 2 2 2 2 2 2 L 2 2 2 2 2 2 2 2 2 3 4 2 2 2 2 2 2 2 2 2 2 2 2 0 0 0 2 2 3 1 4 2 0 0 3 1 0 0 0 0 0 0 0 0
4 0 0 0 1 1 1 1 1 1 1 1 1 1 1 L 1 1 1 1 1 1 1 1 1 1 1 1 1 1 1 1 1 1 1 1 1 1 4 0 0 0 3 1 1 1 1 4 0 0 3 1 0 0 0 0 0 0 0 0
4 2 0 0 0 0 0 0 0 0 0 0 0 0 0 L 0 0 0 0 0 0 0 0 0 0 0 0 0 0 0 0 0 0 0 0 0 0 0 0 0 0 0 0 3 1 4 0 0 0 3 1 0 0 0 0 0 0 0 0
1 4 0 0 0 0 0 0 0 0 0 0 0 0 0 L 0 0 0 0 0 0 0 0 0 0 0 0 0 0 0 0 0 0 0 0 0 0 0 0 0 0 0 0 3 1 4 0 0 0 3 1 0 0 0 0 0 0 0 0
1 4 0 0 0 2 0 0 0 0 0 0 0 0 0 L 0 0 0 0 0 0 0 0 2 0 0 0 0 0 0 0 0 0 0 0 0 0 0 0 0 0 0 0 3 1 4 0 0 0 3 1 0 0 0 0 0 0 0 0
1 4 2 2 2 L 2 0 0 0 0 0 0 0 0 L 0 0 0 0 0 0 2 2 L 2 2 2 0 0 0 0 T 0 D 0 0 0 0 0 0 0 0 0 3 1 4 0 0 0 3 1 0 0 0 0 0 0 0 0
1 1 1 1 4 L 0 0 0 0 0 0 0 G 0 L G A 0 H 0 0 3 4 L 3 1 4 2 2 2 2 2 2 2 2 2 2 2 0 0 0 0 0 3 1 4 2 0 0 3 1 0 0 0 0 0 0 0 0
0 0 0 1 4 L 2 2 2 2 2 2 2 2 2 2 2 2 2 2 2 2 3 4 L 3 1 1 1 1 1 1 1 1 1 1 1 1 4 0 0 0 0 0 3 1 1 4 0 0 3 1 0 0 0 0 0 0 0 0
0 0 0 1 4 L 1 1 1 1 1 1 1 1 1 1 1 1 1 1 1 1 1 4 L 3 0 0 0 0 0 0 0 0 0 0 0 0 0 0 0 0 L 2 3 1 4 0 0 0 3 1 0 0 0 0 0 0 0 0
0 0 0 1 4 L 0 0 0 0 0 0 0 0 0 0 0 0 0 0 0 0 0 0 L 3 0 0 0 0 0 0 0 0 0 0 0 0 0 0 0 0 L 3 1 1 4 0 0 0 3 1 0 0 0 0 0 0 0 0
0 0 0 1 4 2 2 2 2 2 2 2 2 2 2 2 2 2 2 2 2 2 2 2 2 3 0 0 0 0 0 0 0 0 0 0 0 0 0 0 0 0 L 3 1 1 4 0 0 0 3 1 0 0 0 0 0 0 0 0
0 0 0 1 1 1 1 1 1 1 1 1 1 1 1 1 1 1 1 1 1 1 1 1 1 1 0 0 0 0 0 0 0 0 0 0 P 0 0 0 0 0 L 3 1 1 4 2 0 0 3 1 0 0 0 0 0 0 0 0
0 0 0 0 0 0 0 0 0 0 0 0 0 0 0 0 0 0 0 0 0 0 0 0 1 1 0 0 0 0 0 0 0 0 0 2 2 2 2 0 0 0 2 3 1 1 1 4 0 0 3 1 1 1 1 1 1 1 1 1
0 0 0 0 0 0 0 0 0 0 0 0 0 0 0 0 0 0 0 0 0 0 0 0 1 1 0 0 0 0 0 0 0 0 0 0 0 0 0 0 0 0 0 3 1 1 1 4 0 0 3 1 1 1 1 1 1 1 1 1
0 0 0 0 0 1 1 1 1 1 1 1 1 1 1 1 1 1 1 1 1 1 1 1 1 1 0 0 0 0 0 2 2 L 0 0 0 0 0 0 0 0 0 3 1 1 1 4 0 0 0 0 0 0 0 0 0 0 0 0
0 0 0 0 0 1 1 0 0 0 0 0 0 0 0 0 0 0 0 0 0 0 0 0 0 0 0 0 0 0 0 0 0 L 0 0 0 0 0 0 0 0 0 3 1 1 1 4 0 0 0 0 0 0 0 0 0 0 0 0
0 0 0 0 0 1 1 0 0 0 0 0 0 0 0 0 0 0 0 0 0 0 0 0 0 0 0 0 0 0 0 0 0 2 2 2 0 0 0 0 0 0 0 3 1 1 1 4 0 0 0 0 0 0 0 0 0 0 0 0
0 0 0 0 0 1 1 0 0 0 0 0 0 0 0 0 0 2 0 0 0 0 0 0 0 0 0 0 0 0 0 0 0 0 0 0 0 0 0 0 0 2 L 3 1 1 1 4 2 2 2 2 2 2 2 2 2 2 2 2
0 0 0 0 0 1 1 0 0 0 0 0 0 0 0 0 0 L 2 2 2 2 2 2 2 2 2 0 0 0 0 0 0 0 0 0 0 0 0 0 0 0 L 3 1 1 1 1 1 1 1 1 1 1 1 1 1 1 1 1
1 1 1 1 1 1 1 0 0 0 0 0 0 0 0 0 0 L 3 1 1 1 1 1 1 1 4 2 0 0 H 0 T 0 0 0 0 0 G 0 0 0 L 3 1 1 0 0 0 0 0 0 0 0 0 0 0 0 0 0
1 1 1 1 1 1 1 0 0 0 0 0 0 0 0 0 0 L 3 1 0 0 0 0 0 1 1 4 2 2 2 2 2 2 2 2 2 2 2 2 2 2 2 3 1 0 0 0 0 0 0 0 0 0 0 0 0 0 0 0
4 0 0 0 0 0 0 0 0 0 0 0 0 0 0 0 0 L 3 1 0 0 0 0 0 0 1 1 1 1 1 1 1 1 1 1 1 1 1 1 1 1 1 1 1 0 0 0 0 0 0 0 0 0 0 0 0 0 0 0
4 0 0 0 0 0 0 0 0 0 0 0 0 0 0 0 0 2 3 1 0 0 0 0 0 0 0 0 0 0 0 0 0 0 0 0 0 0 0 0 0 0 0 0 0 0 0 0 0 0 0 0 0 0 0 0 0 0 0 0
4 0 0 0 0 0 0 0 0 0 0 0 0 2 0 0 0 0 3 1 0 0 0 0 0 0 0 0 0 0 0 0 0 0 0 0 0 0 0 0 0 0 0 0 0 0 0 0 0 0 0 0 0 0 0 0 0 0 0 0
4 0 0 0 0 0 0 0 0 0 0 0 2 0 0 0 0 0 3 1 0 0 0 0 0 0 0 0 0 0 0 0 0 0 0 0 0 0 0 0 0 0 0 0 0 0 0 0 0 0 0 0 0 0 0 0 0 0 0 0
4 0 0 X 0 G 0 0 0 0 0 2 0 0 0 0 0 0 3 1 0 0 0 0 0 0 0 0 0 0 0 0 0 0 0 0 0 0 0 0 0 0 0 0 0 0 0 0 0 0 0 0 0 0 0 0 0 0 0 0
4 2 2 2 2 2 2 2 2 2 2 2 2 2 2 2 2 2 3 1 0 0 0 0 0 0 0 0 0 0 0 0 0 0 0 0 0 0 0 0 0 0 0 0 0 0 0 0 0 0 0 0 0 0 0 0 0 0 0 0
1 1 1 1 1 1 1 1 1 1 1 1 1 1 1 1 1 1 1 1 0 0 0 0 0 0 0 0 0 0 0 0 0 0 0 0 0 0 0 0 0 0 0 0 0 0 0 0 0 0 0 0 0 0 0 0 0 0 0 0
